RPM,35,50,65,80,95
1500,,,,,
2000,,,,,
2500,,,,,
3000,,,,,
3500,,,,,
4000,,,,,
4500,,,,,
5000,,,,,
5500,,,,,
6000,,,,,
6500,,,,,
